10 6 6 6 6 6 6 6 6 6 6 6 6 6 12
7 1 1 1 1 1 1 1 1 1 1 2 1 1 8
7 0 2 0 2 0 2 3 2 3 2 3 2 0 8
7 3 1 0 1 3 1 4 3 4 1 4 3 3 8
7 3 2 3 2 3 2 0 2 2 2 0 2 3 8
7 3 1 4 3 4 3 3 3 1 1 0 1 4 8
7 2 2 0 2 0 2 4 2 0 2 0 2 0 8
7 1 1 3 1 3 1 0 1 0 2 3 1 3 8
7 2 2 4 2 4 2 0 2 3 2 2 2 4 8
7 3 1 0 1 0 1 0 1 3 3 3 2 3 8
7 4 2 3 2 0 2 0 2 3 2 4 2 4 8
7 0 1 2 3 0 3 0 1 4 3 0 1 0 8
11 9 9 9 9 9 9 9 9 9 9 9 9 9 13