6 6 6 6 6 6 6 6 6 6 6 6 6 6 6
7 1 1 1 1 1 1 1 1 1 1 1 1 1 8
7 0 2 0 2 0 2 0 2 0 2 0 2 0 8
7 0 1 0 1 0 1 0 1 0 1 0 1 0 8
7 0 2 0 2 0 2 0 2 0 2 0 2 0 8
7 3 1 0 1 0 1 0 1 0 0 0 1 0 8
7 3 2 0 2 0 2 0 2 0 2 0 2 0 8
7 0 1 0 1 0 1 0 1 0 1 0 1 0 8
7 0 2 0 2 0 2 0 2 0 2 0 2 0 8
7 0 1 0 1 0 1 0 1 0 1 0 1 0 8
7 0 2 0 2 0 2 0 2 0 2 0 2 0 8
7 0 1 0 1 0 1 0 1 0 1 0 1 0 8
9 9 9 9 9 9 9 9 9 9 9 9 9 9 9