5 5 5 5 5 5 5 5 5 5 5 5 5 5 5
6 0 0 0 0 0 0 0 0 0 0 0 0 0 6
6 0 2 0 2 0 2 0 2 0 2 0 2 0 6
6 0 1 0 1 0 1 0 1 0 1 0 1 0 6
6 0 2 0 2 0 2 0 2 3 2 0 2 0 6
6 0 1 0 1 0 1 0 1 0 3 0 1 0 6
6 0 2 0 2 0 2 0 2 3 2 0 2 0 6
6 0 1 0 1 0 1 0 1 0 1 0 1 0 6
6 3 2 3 2 0 2 0 2 0 2 0 2 0 6
6 0 1 0 1 0 1 0 1 0 1 0 1 0 6
6 0 2 0 2 0 2 3 2 0 2 0 2 0 6
6 0 1 0 1 0 1 0 1 0 1 0 1 0 6
5 5 5 5 5 5 5 5 5 5 5 5 5 5 5