6 6 6 6 6 6 6 6 6 6 6 6 6 6 6
7 1 1 1 1 1 1 1 1 1 2 1 1 1 8
7 3 2 3 2 3 2 0 2 0 2 3 2 0 8
7 3 1 4 2 0 1 3 3 0 1 3 1 3 8
7 0 2 0 2 3 2 4 2 3 2 3 2 0 8
7 0 3 0 3 4 1 2 1 4 1 3 1 0 8
7 3 2 0 2 3 2 3 2 0 2 4 2 0 8
7 4 3 0 1 4 1 4 1 0 1 0 1 0 8
7 3 2 3 2 3 2 0 2 3 2 0 2 0 8
7 4 3 3 3 4 2 0 1 2 1 0 2 0 8
7 0 2 4 2 0 2 3 2 1 2 0 2 3 8
7 0 1 0 3 3 1 4 3 3 1 0 3 0 8
9 9 9 9 9 9 9 9 9 9 9 9 9 9 9